%%%%%%%%%%%%%%%%%%%%%%%%%%%%%%%
%.....%    .............%.....%
%.%%%.% %%% %%%%%%%.%%%.%.....%
%.%...% %......%......%.%.....%
%...%%%G%.%%%%.%.%%%%...%%%...%
%%%.%.% %.%......%..%.%...%.%%%
%...%.%%%.%.%%% %%%.%.%%%.%...%
%.%%%.......%     %.......%%%.%
%...%.%%%%%.%%%%%%%.%.%%%.%...%
%%%.%...%.%....%....%.%...%.%%%
%...%%%.%.%%%%.%.%%%%.%.%%%...%
%.......%......%......%.....%.%
%.....%.%%%.%%%%%%%.%%%.%.%%%.%
%.....%.............%...%....P%
%%%%%%%%%%%%%%%%%%%%%%%%%%%%%%%
