%%%%%%%%%%%%%%%%%%%%
%o   %        %    %
% %% % %%%%%% %% % %
% %              % %
% % %% %%  %% %% % %
%       G  G     % %
% % %% %%%%%% %% % %
% %              % %
% %% % %%%%%% % %% %
%    %   PP   %    %
%%%%%%%%%%%%%%%%%%%%