%%%%%%%%%%%%%%%%%%%%
%o   %        %    %
% %% % %%%%%% %% % %
% %     G   G    % %
% % %% %%  %% %% % %
%       G  G     % %
% % %% %%%%%% %% % %
% %              % %
% %% % %%%%%% % %% %
%    % PPPPP  %    %
%%%%%%%%%%%%%%%%%%%%